Nice simple maze
MaxSteps = 10000
Rows = 15
Cols = 30
############# #              
#             ######
#@            
##############

########################
 #          #      #
#   ###     #      #### #####
#      #    #       #
#   ###     #       
#########  ################
     #  #    #$  
        # #  #########
###########    
#######################