Nice simple maze
MaxSteps = 1000
Rows = 200
Cols = 200

##################
#@               #
################ #
#                #
# ################
#                #
################ #
#$               #
##################
