Nice simple maze
MaxSteps = 1000
Rows = 27
Cols = 14
##############
       @
 #############

  ############

   ###########

    ##########

     #########

      ########

       #######

        ######

         #####

          ####

           #$#

            ##
       
             #
