Nice simple maze
MaxSteps = 1000
Rows = 11
Cols = 13
#           #
    ### #
    #   #
    # ###
  ### #
@ #$  #  
  ### #
    # ###
    #   #
    ### #      
#           #
