maze
MaxSteps=1000
Rows=6
Cols=17
############### #
       #        #
######## ########
@               #
$       #       #
############### #
